11111111
1P00CE01
10000011
100001C1
11111111
