1111111111
1000000001
1000110001
1000110001
1000000001
1000110001
1000000001
1111111111