1111111111111111111111
1C10001011101110101111
1010101111111111111011
1000000P00000000001111
1011101011111010111C11
11111110111010100C1011
1000111011111C10111011
1C10101011111110101011
1110111010001010111011
1000C00C101010000000E1
1111111111111111111111