1111111111111111111
1000010000100000001
1C00E00P11100011001
1C00001000C00011001
1C0001C000C00000001
1000001000C00C01001
100100001000C010011
1110000010000001001
1C00000111C00001011
1C00000000C01C110C1
1111111111111111111