1111111111111111111
1000010000C00000001
1C00E00P00C00000001
1C00001000C00000001
1C0001C100C00000001
1C00001000C00C01001
1C00000000C00C01001
1C00000000C00C01001
1C00000000C00CC1011
1C00000000C01C110C1
1111111111111111111