11111111111
            1000P000001
100P00C0E01
 11111111111