11111111111
1000P000001
10000000EC1
 11111111111