11111111111
1000P100001
100001C0E01
11111111111