11111111111
1000P000001
1X0000C0E01
11111111111